_SOURCE	_SINK	_SINK	global_step	ConstantFoldingCtrl/PiecewiseConstant/case/Assert/AssertGuard/Switch_0/_554	PiecewiseConstant/case/Assert/AssertGuard/Assert/Switch/_557	PiecewiseConstant/case/Assert/AssertGuard/Assert/Switch_1/_559	group_deps_3/_576	Mean/_579	
_SINK	
global_step	global_step/read	AssignAdd	
global_step/read	global_step/read/_544	
global_step/read/_544	_SINK	
ConstantFoldingCtrl/PiecewiseConstant/case/Assert/AssertGuard/Switch_0/_554	ConstantFoldingCtrl/PiecewiseConstant/case/Assert/AssertGuard/Switch_0/_555	
ConstantFoldingCtrl/PiecewiseConstant/case/Assert/AssertGuard/Switch_0/_555	PiecewiseConstant/case/Assert/AssertGuard/Assert/data_0	
PiecewiseConstant/case/Assert/AssertGuard/Assert/data_0	PiecewiseConstant/case/Assert/AssertGuard/Assert	
PiecewiseConstant/case/Assert/AssertGuard/Assert/Switch/_557	PiecewiseConstant/case/Assert/AssertGuard/Assert	
PiecewiseConstant/case/Assert/AssertGuard/Assert/Switch_1/_559	PiecewiseConstant/case/Assert/AssertGuard/Assert	
PiecewiseConstant/case/Assert/AssertGuard/Assert	PiecewiseConstant/case/Assert/AssertGuard/Assert/_560	
PiecewiseConstant/case/Assert/AssertGuard/Assert/_560	PiecewiseConstant/case/Assert/AssertGuard/Assert/_561	
PiecewiseConstant/case/Assert/AssertGuard/Assert/_561	_SINK	
group_deps_3/_576	group_deps_3/_577	
group_deps_3/_577	AssignAdd/value	
AssignAdd/value	AssignAdd	
AssignAdd	_retval_AssignAdd_0_0	
_retval_AssignAdd_0_0	_SINK	
Mean/_579	_retval_Mean_0_1	
_retval_Mean_0_1	_SINK	
